24 16
5	5	7	5	5	5	5	5	5	5	5	5	5	5	0	0	0	0	0	0	0	0	0	0
5	5	5	5	0	0	0	5	7	5	5	5	0	0	0	1	1	1	1	1	1	1	1	5
5	7	5	0	0	0	0	7	5	5	5	7	5	0	0	1	2	0	0	6	0	2	1	5
5	5	5	0	0	0	0	0	0	5	5	0	0	0	0	1	0	6	6	6	5	0	1	7
5	7	0	0	0	6	0	0	0	0	0	0	0	0	0	1	6	6	6	7	7	0	1	5
5	0	0	0	0	6	6	6	6	0	0	0	0	0	0	1	6	6	6	6	6	0	1	5
0	0	0	0	6	6	6	6	6	6	6	6	0	0	0	1	0	5	6	6	5	0	1	7
0	0	0	0	0	0	0	6	7	5	5	5	0	0	0	1	0	5	5	6	5	0	1	5
0	1	1	1	1	1	0	0	0	0	0	0	0	0	2	1	0	5	5	0	5	0	1	5
0	1	2	0	2	1	0	0	1	1	1	1	1	1	1	1	0	5	0	0	0	0	1	5
0	1	0	0	0	1	5	5	1	2	0	0	0	0	0	0	5	5	0	1	1	1	1	0
0	1	0	0	0	1	1	1	1	0	0	0	0	5	5	5	5	5	0	1	2	0	0	0
0	1	6	0	0	0	0	0	0	0	0	0	5	5	5	5	5	5	0	1	0	0	0	0
7	1	6	6	0	0	0	6	6	0	0	5	0	7	7	7	7	5	0	1	1	1	4	0
7	1	6	6	0	0	7	6	6	6	0	5	5	5	7	7	7	5	0	0	0	6	6	6
7	3	6	6	6	6	6	6	6	6	7	0	0	0	0	5	7	0	0	0	0	0	6	6